############################################################
#J    ##                                            #     C#
#     ##                        N                   #N     #
#                                                 Z        #
#### ########################   ############################
#                                                          #
#                                                          #
#        ####################   #####################      #
#        #             Z                         #  #      #
#        #XXXXXX#####  # ######### #             #  #      #
#        #             # ######### #    #        #  #      #
#        #             #    ###    #    #   N    #  #      #
#        #      N      #    #C#XXXX#    #        #  #      #
#        #             #    # #    #    X        #  #      #
#        #             #        N  #    ##XXXXXXX# Z#      #
#        #  ######XXXXX#############             #  #      #
#        #      Z                                   #      #
#        ####################   #####################      #
#                                                          #
#################################                   ########
#C      N      X     X        Z #   N               #Z     #
#            X   X      X                                  #
############################################################